[
NAME: LevelLayout 
    {4, 2, 4, 5, 4},
    {3, 7, 3, 7, 3},
    {4, 5, 0, 5, 4},
    {3, 7, 3, 7, 3},
    {4, 5, 4, 5, 4}
]
[ 
NAME: Level0
    {1, 0, 0, 0, 2},
    {0, 0, 0, 0, 0},
    {0, 0, 0, 0, 0},
    {0, 0, 0, 0, 0},
    {2, 0, 0, 0, 1}
]
[
NAME: Level1
    {1, 0, 0, 0, 1},
    {1, 0, 0, 0, 1},
    {1, 0, 0, 0, 1},
    {1, 0, 0, 0, 1},
    {1, 2, 2, 2, 1}
]
[
NAME: Level2
    {2, 1, 0, 1, 2},
    {1, 0, 0, 0, 1},
    {0, 0, 0, 0, 0},
    {1, 0, 0, 0, 1},
    {2, 1, 0, 1, 2}
]
[
NAME: Level3 
    {1, 1, 0, 1, 1},
    {1, 0, 0, 0, 1},
    {1, 0, 0, 0, 1},
    {1, 0, 0, 0, 1},
    {1, 1, 0, 1, 1}
]
[
NAME: Level4
    {1, 2, 0, 2, 1},
    {1, 0, 0, 0, 1},
    {0, 0, 0, 0, 0},
    {1, 0, 0, 0, 1},
    {1, 2, 0, 2, 1}
]
[
NAME: Level5
    {1, 1, 2, 1, 1},
    {1, 0, 0, 0, 1},
    {0, 0, 0, 0, 0},
    {1, 0, 0, 0, 1},
    {1, 1, 2, 1, 1}
]
[
NAME: Level6
    {1, 1, 1, 1, 1},
    {1, 1, 1, 1, 1},
    {1, 1, 1, 1, 1},
    {1, 1, 1, 1, 1},
    {1, 1, 1, 1, 1}
]
[
NAME: Level7
    {0, 0, 0, 0, 0},
    {0, 0, 0, 0, 0},
    {0, 0, 0, 0, 0},
    {0, 0, 0, 0, 0},
    {0, 0, 0, 0, 0}
]